26 26 26 26 26 26 26 26 26 26 26 26 26 26 26 26 26 26 26 26 26
26 26 26 26 7  3  3  6  26 26 26 26 26 26 26 26 26 26 26 26 26
26 26 26 26 4  28 28 2  26 26 26 26 26 25 25 26 26 26 26 26 26
26 26 26 26 8  1  1  5  26 26 26 26 26 26 26 26 26 26 26 26 26
26 26 26 26 26 26 26 26 26 26 26 26 26 26 26 26 26 26 26 26 26
3 3 3 3 3 3 3 3 3 3 3 3 3 3 3 3 3 3 3 3 3
28 28 28 28 28 28 28 28 28 28 28 28 28 28 28 28 28 28 28 28 28
9 9 9 9 9 9 9 9 9 9 9 9 9 9 9 9 9 9 9 9 9
27 27 27 27 27 27 27 27 27 27 27 27 27 27 27 27 27 27 27 27 27
27 27 27 27 15 11 11 14 27 27 27 27 27 27 27 27 27 27 27 27 27
27 27 27 27 12 28 28 10 27 27 27 27 27 27 27 27 27 27 27 27 27
27 27 27 27 16 9  9  13 27 27 27 27 27 27 27 27 27 27 27 27 27
27 27 27 27 27 27 27 27 27 27 27 27 27 27 27 27 27 27 27 27 27
11 11 11 11 11 11 11 11 11 11 11 11 11 11 11 11 11 11 11 11 11
24 24 24 24 24 24 24 24 24 24 24 24 24 24 24 24 24 24 24 24 24
25 25 25 25 25 25 25 25 25 25 25 25 25 25 25 25 25 25 25 25 25
25 25 22 18 18 18 18 18 18 18 18 18 18 18 21 25 25 18 21 25 25
25 25 19 28 28 28 28 28 28 28 28 28 28 28 17 25 25 28 17 25 25
25 25 19 28 28 28 28 28 28 28 28 28 28 28 17 25 25 28 17 25 25
25 25 19 28 28 28 28 28 28 28 28 28 28 28 17 25 25 28 17 25 25
25 25 19 28 28 28 28 28 28 28 28 28 28 28 17 25 25 28 17 25 25
25 25 19 28 28 28 28 28 28 28 28 28 28 28 17 25 25 28 17 25 25
25 25 19 28 28 28 28 28 28 28 28 28 28 28 17 25 25 28 17 25 25
25 25 23 24 24 24 24 24 24 24 24 24 24 24 20 25 25 24 20 25 25
25 25 25 25 25 25 25 25 25 25 25 25 25 25 25 25 25 25 25 25 25